JACOB|JACOB
MASON|MICHAEL
ETHAN|JOSHUA
NOAH|MATTHEW
WILLIAM|ETHAN
LIAM|ANDREW
MICHAEL|JOSEPH
JAYDEN|CHRISTOPHER
ALEXANDER|NICHOLAS
AIDEN|DANIEL
DANIEL|WILLIAM
MATTHEW|ANTHONY
ELIJAH|DAVID
JAMES|TYLER
ANTHONY|ALEXANDER
BENJAMIN|RYAN
JOSHUA|JOHN
ANDREW|JAMES
JOSEPH|ZACHARY
DAVID|BRANDON
JACKSON|JONATHAN
LOGAN|JUSTIN
CHRISTOPHER|DYLAN
GABRIEL|CHRISTIAN
SAMUEL|SAMUEL
RYAN|AUSTIN
LUCAS|BENJAMIN
JOHN|NATHAN
NATHAN|LOGAN
ISAAC|JOSE
DYLAN|NOAH
CALEB|GABRIEL
CHRISTIAN|KEVIN
LANDON|ROBERT
JONATHAN|CALEB
CARTER|THOMAS
LUKE|JORDAN
OWEN|HUNTER
BRAYDEN|CAMERON
GAVIN|KYLE
WYATT|ELIJAH
ISAIAH|JASON
HENRY|AARON
ELI|JACK
HUNTER|ISAIAH
JACK|LUKE
EVAN|CONNOR
JORDAN|ISAAC
NICHOLAS|ANGEL
TYLER|JACKSON
AARON|BRIAN
JEREMIAH|ERIC
JULIAN|MASON
CAMERON|JUAN
LEVI|ADAM
BRANDON|EVAN
ANGEL|LUIS
AUSTIN|CHARLES
CONNOR|SEAN
ADRIAN|AIDAN
CHARLES|GAVIN
ROBERT|NATHANIEL
THOMAS|ALEX
SEBASTIAN|BRYAN
COLTON|CARLOS
JAXON|JESUS
ZACHARY|IAN
KEVIN|STEVEN
AYDEN|COLE
DOMINIC|TIMOTHY
BLAKE|CODY
JOSE|SETH
OLIVER|ADRIAN
JUSTIN|DEVIN
BENTLEY|LUCAS
JASON|BLAKE
CHASE|RICHARD
IAN|JULIAN
JOSIAH|PATRICK
XAVIER|SEBASTIAN
PARKER|TREVOR
ADAM|CHASE
COOPER|DOMINIC
NATHANIEL|JARED
GRAYSON|ANTONIO
JACE|JEREMIAH
CARSON|XAVIER
NOLAN|JADEN
TRISTAN|MIGUEL
LUIS|JESSE
BRODY|GARRETT
JUAN|ALEJANDRO
HUDSON|MARK
BRYSON|OWEN
CARLOS|JEREMY
EASTON|HAYDEN
DAMIAN|BRYCE
KAYDEN|DIEGO
ALEX|RILEY
RYDER|VICTOR
JESUS|JAYDEN
COLE|JAKE
MICAH|TRISTAN
VINCENT|KENNETH
MAX|CARSON
JAXSON|MARCUS
ERIC|DAKOTA
ASHER|CARTER
HAYDEN|JORGE
DIEGO|SPENCER
MILES|TANNER
STEVEN|KALEB
IVAN|LIAM
ELIAS|STEPHEN
MAXWELL|HENRY
AIDAN|COLIN
BRYCE|DALTON
ANTONIO|PAUL
TIMOTHY|EDWARD
GIOVANNI|OSCAR
BRYAN|WYATT
SANTIAGO|JOEL
COLIN|VINCENT
RICHARD|BRENDAN
BRAXTON|COLBY
KALEB|PARKER
KYLE|GRANT
JONAH|COLTON
KADEN|MAXWELL
PRESTON|SHANE
MIGUEL|GEORGE
LINCOLN|JEFFREY
RILEY|EDUARDO
LEO|PETER
VICTOR|AIDEN
BRADY|IVAN
MATEO|NICOLAS
JEREMY|BRAYDEN
JADEN|DEREK
BRIAN|GAGE
ASHTON|FRANCISCO
PATRICK|LANDON
DECLAN|RICARDO
SEAN|TRAVIS
JOEL|CRISTIAN
GAEL|JALEN
SAWYER|BRADY
ALEJANDRO|COLLIN
MARCUS|BRADLEY
JESSE|ALAN
LEONARDO|OMAR
CADEN|SHAWN
JAKE|CADEN
KAIDEN|JOSIAH
WESLEY|PRESTON
CAMDEN|ERIK
EDWARD|ANDRES
BRANTLEY|JAVIER
ROMAN|FERNANDO
SILAS|DEVON
AXEL|ALEXIS
JUDE|CESAR
GRANT|DAMIAN
CAYDEN|MANUEL
EMMANUEL|MAX
GEORGE|JONAH
MADDOX|LEVI
MALACHI|BRADEN
BRADLEY|GREGORY
ALAN|JOHNATHAN
WESTON|MARIO
GAGE|NOLAN
GREYSON|MICAH
DEVIN|KADEN
KENNETH|EDGAR
MARK|RAYMOND
OSCAR|MITCHELL
TANNER|CLAYTON
RYLAN|EDWIN
NICOLAS|TRENTON
HARRISON|COREY
DEREK|ERICK
EZRA|WESLEY
PEYTON|EMMANUEL
TUCKER|SCOTT
EMMETT|MARCO
AVERY|SERGIO
CODY|ROBERTO
CALVIN|DUSTIN
ABRAHAM|TAYLOR
ANDRES|DONOVAN
ABEL|MARTIN
JORGE|DAWSON
PAUL|HECTOR
THEODORE|COOPER
KAI|CONNER
COLLIN|ELI
EZEKIEL|BRETT
OMAR|HARRISON
JAYCE|ASHTON
BENNETT|DILLON
CONNER|GIOVANNI
TREVOR|JAKOB
PETER|ABRAHAM
EDUARDO|PEYTON
MAXIMUS|ALEC
JAIDEN|ANDY
JAMESON|CADE
SETH|ANDRE
KINGSTON|MALACHI
JAVIER|MALIK
TRAVIS|DAMIEN
GARRETT|TREY
EVERETT|TY
GRAHAM|JAYLEN
XANDER|FRANK
CRISTIAN|DREW
DAMIEN|ELIAS
GRIFFIN|RUBEN
RYKER|JOSUE
CORBIN|CALVIN
LUCA|SKYLER
MYLES|ZANE
ZANE|DOMINICK
FRANCISCO|PEDRO
RICARDO|PHILLIP
ALEXIS|RONALD
STEPHEN|GRIFFIN
ZAYDEN|BRYSON
IKER|LEONARDO
DRAKE|TRENT
LUKAS|RAFAEL
CHARLIE|CHANCE
SPENCER|GERARDO
ZION|DERRICK
ERICK|JOHNNY
JOSUE|DARIUS
TRENTON|CHANDLER
JEFFREY|MILES
CHANCE|RAUL
ELLIOT|CASEY
PAXTON|SIMON
FERNANDO|ARMANDO
LANDEN|KOBE
SHANE|AVERY
KEEGAN|ALLEN
AMIR|MARCOS
MANUEL|KEITH
ZANDER|TROY
RAYMOND|ENRIQUE
ANDRE|ISRAEL
ISRAEL|DONALD
MARIO|KEEGAN
SIMON|ZACKARY
CESAR|JULIO
KING|PAYTON
JAYLEN|DANTE
JOHNATHAN|JAIME
TROY|BRENDEN
DEAN|KAMERON
CLAYTON|LANCE
DOMINICK|ALBERTO
TYSON|PHILIP
JASPER|BROCK
MARTIN|GUSTAVO
HECTOR|DRAKE
KYLER|JIMMY
EDGAR|OLIVER
CASH|JONATHON
MARCO|DANNY
EDWIN|FABIAN
SHAWN|LOUIS
JUDAH|MATHEW
DONOVAN|BRENNAN
ANDY|CORY
KAMERON|KAI
ELLIOTT|KYLER
DANTE|ANGELO
BRAYLON|BRODY
ANDERSON|DENNIS
DREW|JACE
SERGIO|TONY
JOHNNY|MARC
CRUZ|GARY
RAFAEL|ROMAN
DALTON|CAMDEN
LANE|JERRY
GREGORY|ARTURO
SKYLER|SAUL
ERIK|DAMON
FINN|CURTIS
REID|CORBIN
GUNNER|RANDY
JARED|EMANUEL
CAIDEN|PABLO
HOLDEN|TUCKER
EMILIO|LORENZO
FABIAN|ALBERT
ADEN|LANE
BRENDAN|THEODORE
ROWAN|MYLES
EMILIANO|DARREN
BRADEN|ALFREDO
JASE|BRYANT
JAX|DOUGLAS
EMANUEL|LARRY
LORENZO|TYSON
ROBERTO|GRAYSON
AMARI|CHAD
ANGELO|JAXON
BEAU|JOE
LOUIS|QUINN
DERRICK|MAXIMUS
BECKETT|AXEL
FELIX|MELVIN
DAWSON|TRISTEN
PEDRO|NICKOLAS
BRENNAN|LUKAS
FRANK|ALI
QUINN|RAMON
DALLAS|SANTIAGO
MAXIMILIANO|AYDEN
ROMEO|ZACHERY
JOAQUIN|ERNESTO
WAYLON|BAILEY
BRAYLEN|ARTHUR
MILO|RUSSELL
ALLEN|BRAXTON
COLT|KRISTOPHER
RUBEN|JAYSON
JULIUS|WALTER
AUGUST|JUSTICE
DAKOTA|ZION
GRADY|JAY
BROCK|ESTEBAN
COHEN|MOISES
KELLEN|EMILIO
BRYCEN|ISMAEL
DESMOND|LEO
MALIK|DALLAS
COLBY|RICKY
NEHEMIAH|TOMMY
LELAND|SALVADOR
MARCOS|MARVIN
JETT|LAWRENCE
TY|EZEKIEL
KARTER|MICHEAL
MARSHALL|CAMRON
TAYLOR|CARL
PHILLIP|REECE
COREY|QUENTIN
ADAN|MAURICIO
ALI|ABEL
DILLON|MATEO
ARTHUR|BRAYAN
LEON|JAHEIM
MAVERICK|ISIAH
BROOKS|NIKOLAS
TITUS|AMIR
TRISTEN|BRAEDEN
KEITH|JEFFERY
DEXTER|BRENT
EMERSON|JAMAL
KARSON|DEANDRE
LANDYN|JON
PABLO|KADE
ARMANDO|MARSHALL
ENRIQUE|BRANDEN
KNOX|RODNEY
CADE|HUGO
GERARDO|DEAN
REED|ORLANDO
KELLAN|MORGAN
JAYSON|JAIDEN
BARRETT|CAYDEN
WALTER|JARRETT
DUSTIN|MAURICE
RONALD|CRAIG
KOLTON|TERRY
PHOENIX|WESTON
TRENT|CHRIS
ISMAEL|EDDIE
JULIO|SKYLAR
DANNY|KOLBY
SCOTT|ROGER
KASON|JAYLIN
JAY|REESE
MESSIAH|CONOR
TATE|KEATON
GIDEON|DAVIS
ESTEBAN|KODY
ABRAM|RODRIGO
TREY|TREVON
KEATON|FELIX
JAKOB|KELVIN
JAIME|ZACHARIAH
DEVON|JESSIE
BRAYDON|JAYLON
IZAIAH|BOBBY
DARIUS|BRENDON
ALBERT|SHAUN
DONALD|JAVON
RAUL|JULIUS
ARCHER|AHMAD
COLTEN|GUILLERMO
RIVER|WALKER
DAMON|QUINTON
PHILIP|ALDO
ATTICUS|ZACKERY
GUSTAVO|GRAHAM
MATTEO|NELSON
WALKER|HOLDEN
RANDY|ISSAC
SAUL|JOHNATHON
DAVIS|JADON
ROCCO|CHARLIE
NOEL|CLAY
ENZO|OSVALDO
ORION|DORIAN
JAMARI|RENE
BRUCE|DEMETRIUS
REMINGTON|KHALIL
DARREN|BILLY
LARRY|DESMOND
MATHEW|REGINALD
DENNIS|MALCOLM
RUSSELL|FREDERICK
TONY|DAMION
CHRIS|NASIR
PORTER|QUINCY
RODRIGO|SILAS
ZACHARIAH|BLAINE
ARMANI|HARLEY
HUGO|DAVION
ZAIDEN|JONAS
ARI|ELLIOT
KADE|WILLIE
SOLOMON|EZRA
KAMDEN|ROY
MOHAMED|DECLAN
QUENTIN|TERRANCE
CURTIS|SAM
ISSAC|ADAN
LEONEL|GERALD
JERRY|BENNETT
KHALIL|REID
ALBERTO|JERMAINE
ALEC|KENNY
GIANNI|NOEL
GUNNAR|URIEL
MOISES|FELIPE
ADRIEL|STEVE
LAWRENCE|TYRESE
ALIJAH|NATHANAEL
CHANDLER|TATE
RONAN|DANE
PAYTON|KRISTIAN
PRINCE|EMILIANO
RICKY|ALVIN
ARTURO|SOLOMON
ORLANDO|KENDALL
MITCHELL|TOMAS
CASON|NOE
JIMMY|TRISTON
MAXIMILIAN|ADEN
MUHAMMAD|BRUCE
MALCOLM|WILSON
CYRUS|TODD
JONAS|FRANKLIN
KASEN|MOSES
MARVIN|CYRUS
JALEN|AMARI
WARREN|TERRELL
MAURICIO|RYLAN
RHYS|TOBY
KENDRICK|LANDEN
PIERCE|ALLAN
DANE|ROGELIO
RYLAND|DARIAN
JOHAN|HUDSON
RORY|CEDRIC
URIEL|MAXIMILIAN
BRYANT|JASPER
MAJOR|ASHER
REECE|JAQUAN
CASEY|BYRON
IBRAHIM|DUNCAN
NIKOLAS|JEROME
SULLIVAN|STANLEY
FINNEGAN|TRISTIN
ARJUN|LEON
ALFREDO|KENDRICK
ROYCE|ALFONSO
AHMED|REED
LANCE|DALE
AMARE|JOAQUIN
JAMISON|FRANCIS
RAMON|DAYTON
BRENDEN|SAWYER
DOMINIK|COBY
BRAYAN|MARQUIS
MAURICE|KAYDEN
KRISTOPHER|BEAU
MEKHI|MOHAMED
CASE|RODOLFO
KOBE|RAMIRO
RHETT|TYRONE
ZACKARY|AHMED
JENSEN|JOEY
JAXTON|DEVEN
DEANDRE|JOHAN
ISAIAS|MARLON
CHANNING|RANDALL
TOBIAS|ARIEL
TALON|DEVAN
YAHIR|LEE
EZEQUIEL|BRAYDON
JUSTICE|PIERCE
SAM|HARRY
KASH|ROHAN
ALVIN|TRACE
JACOBY|GILBERTO
MOSHE|ALONZO
NASH|JAYDON
NICO|LUCA
ACE|KAIDEN
QUINTON|WARREN
FRANKLIN|JAMIE
BECKHAM|TOBIAS
CANNON|JUDE
JOE|ROSS
LAWSON|MOHAMMAD
RAIDEN|ZANDER
GARY|OMARION
RAYLAN|TYRELL
ALDO|ELLIOTT
CARL|ROLANDO
FREDERICK|WAYNE
LONDON|WADE
BOSTON|EASTON
BYRON|JAYCE
MOSES|LEONEL
TERRY|ULISES
ERNESTO|XANDER
EDDIE|MEKHI
KANE|BEN
FINLEY|DARRELL
KELVIN|EUGENE
REESE|WILL
SALVADOR|ADDISON
CLARK|RONNIE
MADDEN|ISAIAS
WADE|JORDON
CULLEN|COLEMAN
KIERAN|JAROD
MOHAMMED|KIERAN
JAGGER|VICENTE
NELSON|GUNNAR
DORIAN|TERRENCE
KORBIN|DESHAWN
NASIR|EZEQUIEL
ROY|COLTEN
ASA|LEONARD
MATIAS|IZAIAH
ROGER|RUDY
NICKOLAS|JAMARI
ALONZO|ROMEO
CALLEN|ADOLFO
JAXEN|KOLTON
SKYLAR|MOHAMMED
MALAKAI|SAVION
DOUGLAS|GARRET
URIAH|TYREE
AHMAD|NEIL
CONOR|SAGE
BENTLEE|ALVARO
BRAEDEN|DOMINIQUE
KRISTIAN|DOMINIK
BLAINE|KOBY
CARMELO|RAY
KAYSON|JAXSON
MORGAN|EFRAIN
JULIEN|BRENNEN
NATHANAEL|ORION
AARAV|JARON
KEAGAN|MAXIMILIANO
LUCIAN|HAROLD
CHAD|KEENAN
TERRANCE|STERLING
BENSON|EVERETT
NOE|ERNEST
FRANCIS|GILBERT
RODNEY|DAVON
LAYNE|HUMBERTO
MOHAMMAD|LEWIS
ZAYNE|MIKE
BRETT|SALVATORE
TATUM|RASHAD
WILSON|AGUSTIN
DAYTON|TITUS
KIAN|DONTE
MARC|ELISHA
NIKOLAI|JETT
ROHAN|YAHIR
BRAIDEN|BRICE
HARPER|DARRYL
LUCIANO|DASHAWN
KAMARI|JULIEN
CAMRON|KARL
ELLIS|LINCOLN
JOEY|RIVER
LAYTON|DARIEN
SANTINO|KOLE
WINSTON|GRADY
XZAVIER|DWAYNE
DEMETRIUS|PHOENIX
JEFFERSON|GLENN
GUILLERMO|JAMAR
BOWEN|CULLEN
NEIL|JAMESON
DAXTON|KADIN
MELVIN|ALONSO
RAPHAEL|JAIRO
SOREN|KAREEM
SYLAS|KEON
JON|ANTOINE
BRODIE|JAIR
REX|ELVIS
SHAUN|QUINTIN
YUSUF|RALPH
TOMMY|MOSHE
QUINCY|DAVIN
HARLEY|DEVONTE
DAX|JUNIOR
TRACE|NATHANIAL
LUKA|CRISTOPHER
ADONIS|GUNNER
BENTLY|IGNACIO
ODIN|RODERICK
GIOVANI|KANE
JEFFERY|CRUZ
LEWIS|FREDDY
KYLAN|ARON
KENDALL|KESHAWN
WILLIE|JAMISON
CORY|IRVIN
DAVION|JUSTUS
TRIPP|JUDAH
VIHAAN|TALON
ARIAN|SHAMAR
JAMARION|ANTON
EMERY|JAGGER
JONATHON|MARKUS
NIXON|NEHEMIAH
RAYAN|KAMRON
JERMAINE|ZECHARIAH
EMMITT|ALFRED
REGINALD|DERICK
ZECHARIAH|IBRAHIM
TOMAS|MUHAMMAD
HAMZA|GARRISON
MICHEAL|MARQUISE
AYAAN|STEFAN
BILLY|ANDERSON
URIJAH|AUGUST
JASIAH|DEVYN
ARYAN|NIGEL
CROSBY|DAQUAN
LANDRY|RHETT
LEE|KURT
MATHIAS|ASA
TOBY|REYNALDO
DEACON|HEATH
TRISTIAN|KEYSHAWN
WILL|GORDON
EDEN|JOSH
STERLING|SIDNEY
TERRELL|DONAVAN
FELIPE|KARSON
TRISTON|CAIDEN
ARON|KELLEN
MAKAI|RAPHAEL
MATTHIAS|JARRED
HANK|ALIJAH
JAMAL|ZAKARY
MAXIM|PORTER
GERALD|SHELDON
NIKO|HOWARD
YOSEF|OCTAVIO
ALESSANDRO|RIGOBERTO
BRANSON|LAYNE
JAYDON|CLARENCE
HAYES|DARNELL
AUGUSTUS|DEON
FLYNN|JEAN
MARLON|MILTON
ALLAN|MISAEL
CHAIM|RORY
JESSIE|OMARI
KODY|DILLAN
MAYSON|EMMETT
AYDAN|JAYLAN
NEYMAR|BRODIE
ADRIEN|DEMARCUS
JEROME|JABARI
LEONARD|GREYSON
SINCERE|JEFFERSON
TERRENCE|KENYON
KYSON|DENZEL
JADIEL|DARION
OMARI|GIANNI
KOLE|ALESSANDRO
AYDIN|ARI
BOBBY|JAEDEN
VICENTE|KEVON
ZAIN|KEYON
RONNIE|NICO
ALEXZANDER|DANDRE
KALE|ALEXANDRO
HARRY|AMARION
SAGE|DRAVEN
ROGELIO|GAEL
CASEN|RYDER
RAY|CLINTON
CLAY|ISAI
MASEN|KEAGAN
ULISES|SANTOS
JADON|GAVEN
KYMANI|GONZALO
JAVON|LAMAR
ELISHA|CAMREN
BRENT|GEOFFREY
STANLEY|JARROD
EUGENE|KOREY
JOVANNI|BRYCEN
PRINCETON|ROLAND
ALONSO|DALLIN
CONRAD|BROOKS
DARIAN|TARIQ
DWAYNE|DANGELO
RENE|JAHIEM
ROLAND|MAXIMILLIAN
GAUGE|SHANNON
KAREEM|THADDEUS
BEN|CONRAD
ABDULLAH|FRANKIE
VINCENZO|BRAD
BLAZE|CALE
CAMREN|QUINTEN
DESHAWN|XZAVIER
EDISON|ABDULLAH
KENNY|BRAIDEN
BRENTLEY|SEMAJ
MEMPHIS|AUSTYN
OSVALDO|STEPHAN
STEVE|WAYLON
CEDRIC|BABY
TEAGAN|PERRY
WESTIN|BERNARD
RAYDEN|GERMAN
DRAVEN|HAMZA
GIOVANNY|KELTON
MARQUIS|ALEXZANDER
SAMIR|HASSAN
BRENNEN|ROCCO
JAIRO|SINCERE
RONIN|GIANCARLO
BRONSON|JACOBY
ARIEL|RONALDO
DAVIN|TRAVON
ALDEN|ELMER
CREW|EMERSON
KOLTEN|GUADALUPE
SEMAJ|REAGAN
ISIAH|REUBEN
LENNOX|ARMANI
DAVIAN|CAEL
CRAIG|JOVAN
CRISTOPHER|GIDEON
JAYLIN|JAREN
JUSTUS|JOAN
CAIN|KHALID
LAMAR|SHEA
LEONIDAS|ANTONY
OTTO|BRUNO
WAYNE|DARIN
BO|DARRIUS
DARRELL|DIMITRI
FLETCHER|TRISTIAN
KOLBY|DEONTE
BRUNO|JAMEL
HARVEY|JORDEN
MARCELO|WINSTON
AIDYN|BLAZE
THEO|JAVION
ALFONSO|MATTEO
RUDY|ESTEVAN
TYRONE|JOVANI
KAEDEN|MAVERICK
SAMSON|TRE
BRENDON|SEAMUS
TRISTIN|BLAISE
DOMINIQUE|FINN
KYREE|HERIBERTO
AMOS|ISAAK
JOVANI|KEANU
LIONEL|CLARK
CALLUM|LEROY
MISAEL|MILO
QUINTIN|DESTIN
VALENTINO|JORDY
GIANCARLO|SONNY
GAVYN|CHAZ
LENNON|NORMAN
ARLO|ULYSSES
JUNIOR|ELIAN
KILLIAN|KORBIN
ZAVIER|AUSTEN
JAMIR|DEANGELO
KAMRON|DEXTER
LEANDRO|ROWAN
KONNOR|BRAEDON
HEZEKIAH|REILLY
CHACE|RONAN
JOHNATHON|TREVION
RAMIRO|JUSTYN
CALLAN|TREYTON
DUNCAN|EARL
JORDYN|STONE
LYRIC|YOSEF
MARKUS|ADRIEN
FISHER|DION
LEGEND|FREDRICK
RASHAD|NICK
HAROLD|SAMMY
KAMRYN|TYLOR
HENDRIX|BRENTON
SEAMUS|KURTIS
CAMILO|KEVEN
COLEMAN|SAMIR
RYLEE|ABRAM
VANCE|AUGUSTUS
ELIAN|CLIFFORD
JAMIE|LAWSON
KRISH|PAXTON
ABDIEL|VANCE
ANTOINE|DARIO
GIBSON|NESTOR
JAEDEN|BERNARDO
VAN|JAKOBE
CAMDYN|JOSEF
BRANDEN|KENNEDY
CAYSON|MARCEL
IZAYAH|COLT
JAVION|DESHAUN
DARWIN|FORREST
HASSAN|NATHEN
JAMAR|TAVION
THIAGO|BARRY
MIKE|KIAN
RANDALL|BENNY
BRECKEN|DOMENIC
HEATH|GAVYN
KINGSLEY|SHAYNE
VAUGHN|CORNELIUS
ARNAV|HUGH
DEANGELO|ADITYA
KYRIE|ADONIS
JIONNI|BRET
JOZIAH|CORDELL
MAKHI|STUART
XAVI|ARYAN
ZEKE|JADYN
DAMARI|IRVING
KONNER|KYLAN
BENTON|LAMONT
EAN|LONDON
OAKLEY|MARCELO
FRANKIE|NASH
YAEL|TREVER
EFRAIN|FRED
MARCEL|HOUSTON
BODHI|LATRELL
JEDIDIAH|KELLY
KEENAN|REMINGTON
ROLANDO|OSWALDO
ROWEN|TYSHAWN
MAXTON|CHAIM
ISHAAN|EFREN
JAYCOB|SAMSON
TODD|JAHEEM
YOUSEF|NIKHIL
REAGAN|ZAIRE
REMY|DARYL
DAMARION|GLEN
JUELZ|LAYTON
VALENTIN|PRANAV
ANDERS|ARNOLD
AUSTYN|MALAKAI
YEHUDA|DARWIN
BRODERICK|FIDEL
THADDEUS|JAVEN
ALVARO|KALE
MUSTAFA|LISANDRO
BRENTON|ALDEN
CALE|SANTINO
GILBERTO|STEPHON
JORDEN|DYLON
SALVATORE|ELLIS
CLINTON|LONNIE
DERICK|ADRIEL
DONTE|DUANE
FREDDY|ETHEN
JABARI|RAYMUNDO
LUCCA|CARLTON
REY|GINO
DARIO|GIOVANNY
AADEN|JAN
ERNEST|REY
SIDNEY|HADEN
AXTON|MARQUEZ
BLAISE|VERNON
DEEGAN|ZAIN
MAXIMO|BARRETT
TREVON|LUCIANO
RODOLFO|MITCHEL
SONNY|TURNER
CAMRYN|ZAVIER
HUGH|GAIGE
LEROY|GUY
TRUMAN|KASEY
CASSIUS|LUC
AGUSTIN|MAXIMO
BRICE|RICKEY
BROGAN|RYLEE
BRIDGER|VAUGHN
ELIOT|ANTWAN
ELISEO|AUBREY
STEFAN|CASON
ZAID|ELISEO
DEMARCUS|JAMIL
JOHANN|RAHUL
DAMION|DARRIN
HOUSTON|DARRION
SHELDON|MUSTAFA
TYRELL|JAMIR
ALFRED|JEVON
DARIEL|MIKEL
DARRYL|PIERRE
ISAI|TRYSTAN
KOHEN|BILAL
RYLEN|KENT
CAEL|KYREE
ROSS|MAXIM
SANTOS|NEAL
DAVON|SABASTIAN
IGNACIO|SYED
KAYSEN|EDDY
MACK|GANNON
TITAN|JAQUEZ
TYREE|ARJUN
DARIEN|JARVIS
TURNER|JOVANY
ADITYA|BRADYN
AMEER|CARLO
BRIGGS|DONTAE
IMMANUEL|JASE
KASE|ZAYNE
MALAKI|CLIFTON
REUBEN|CORTEZ
ZAIRE|SHEMAR
GRAYSEN|DWIGHT
BRADYN|KORY
GAIGE|AMOS
TRYSTAN|DEVANTE
YANDEL|HERBERT
EMORY|IMMANUEL
JAIDYN|JEFF
FRANCO|KIRK
ANTON|OSBALDO
DARNELL|PRINCE
MAISON|TREVIN
RODERICK|ZACK
SIMEON|FREDDIE
DEON|GARETT
GRAEME|KRISTOFER
HOWARD|RYLEY
APOLLO|BO
DEVAN|CRISTOBAL
JAEL|ELIEZER
JARRETT|GIOVANI
KAEL|SULLIVAN
KARSEN|LLOYD
DENZEL|NIKO
FOSTER|RAVEN
GARRISON|EAN
GILBERT|JOVANNI
JAYLON|ALTON
KAMDYN|GERARD
AUGUSTINE|KEANDRE
